10 10
+ +-+-+-+-+-+-+-+-+-+
|   |   |   |   |   |
+-+ +-+ + +-+ +-+ +-+
| |       |   |     |
+ +-+-+ + + +-+-+-+ +
|     | |       |   |
+-+ + + + +-+-+-+-+ +
|   | | |         | |
+ +-+ + +-+ +-+-+ + +
| |   |   | |       |
+-+ +-+ +-+-+-+-+-+-+
| |           |     |
+ +-+ +-+-+ +-+ +-+-+
|   | | |     |   | |
+-+ + + +-+-+ + + + +
|*  | |         |   |
+ +-+ +-+ + +-+-+-+ +
|       | |   |     |
+ +-+ +-+-+-+ +-+-+ +
|   |   |     |     |
+-+-+-+-+-+-+-+-+-+ +
